Africa
20
11
--------------------
-....-......----..K-
-.-S............U..-
-.-.....A...----N.B-
-.-.......-.----...-
-..................-
-H.................-
-.........-......-D-
-A...............-.-
-B....-.-...T.Q..-F-
--------------------
P-12,0-0
P-12,0-1
P-13,0-1
P-14,0-2
P-15,0-3
J-14,5
J-14,6
G-7,9
R-5,9
#C-12,7

